+--+--+--+--+--+--+--+--+--+--+
X     |     |                 |
+--+  +  +  +--+--+--+--+--+  +
|     |  |     |              |
+  +--+  +  +  +--+--+--+  +--+
|     |  |  |  |     |     |  |
+  +  +  +  +  +  +  +  +--+  +
|  |     |  |     |           |
+--+--+--+--+--+--+--+  +  +--+
|                       |  |  |
+  +--+  +--+--+--+--+--+  +  +
|     |  |     |     |     |  |
+--+  +  +  +  +--+  +  +  +  +
|  |  |     |        |  |  |  |
+  +  +--+--+--+--+--+  +--+  +
|     |     |           |     |
+--+--+  +  +  +--+--+--+  +--+
|  |     |     |              |
+  +  +--+--+--+--+--+--+  +  +
|                          |  O
+--+--+--+--+--+--+--+--+--+--+
